goal_maximize,goal_standard,goal_optimize,goal_full,goal_partial,measure_easy,measure_immediate,outcome_certain,outcome_probablistic,solution_valid,solution_optimal,solution_count,solution_singularity,solution_path,solution_objectivity,solution_verifiability,solution_demonstrability,stakeholder_multiplicity,metric_multiplicity,objective_multiplicity,solution_multiplicity,metric_multiplicity_tradeoff,individual_theoretical,individual_practical,group_dependencies,participation_equal,conflict_cooperation,conflict_interests,external_adversary,external_standard,task_divisibility,task_specialization,skills_specialization,subtasks_additive,subtasks_disjunctive,performance_worst,performance_best,performance_random,performance_average,performance_cumulative,submission_together,submission_separate,subtasks_discretionary_weight,subtasks_discretionary_combination,effort_mental,effort_physical,generate_plan,generate_process,generate_ideas,generate_creativity,resolve_opinion,resolve_perspectives,resolve_information,resolve_data,options_evaluating,options_independent,options_dependent
1,5,1,5,1,5,5,5,1,1,5,1,5,5,5,5,5,0,1,1,1,1,1,5,1,1,1,1,5,5,1,1,1,1,5,1,5,1,1,1,5,1,5,5,5,1,1,1,1,5,1,4,1,1,5,1,5
1,5,5,4,2,5,5,5,1,1,5,1,5,5,5,5,5,1,1,1,1,1,1,5,1,1,1,1,1,5,1,1,5,2,1,1,1,1,1,5,1,5,1,1,5,1,1,1,1,5,5,5,5,1,5,1,5
1,5,5,5,1,5,1,1,5,5,1,5,1,5,1,1,1,5,0,5,5,1,1,5,4,5,1,1,5,1,5,5,5,5,1,5,5,1,1,5,5,1,5,5,5,1,1,1,5,5,5,5,1,1,5,1,5
1,5,5,1,5,5,4,1,1,5,5,5,1,5,5,5,5,5,0,5,5,5,5,1,5,5,5,5,1,5,5,5,5,5,5,5,5,1,1,5,5,1,5,5,5,1,5,5,1,1,5,5,5,5,5,1,5
1,5,1,5,1,5,5,1,5,5,1,5,1,1,1,1,1,5,0,5,5,5,1,5,1,5,1,5,1,5,1,1,5,5,1,1,1,1,1,5,5,1,5,5,5,1,5,1,5,1,5,5,1,1,5,1,5
1,5,5,1,5,5,4,2,4,5,2,5,1,5,5,5,1,2,5,5,5,5,1,5,5,5,1,1,1,5,5,5,5,4,4,1,4,1,1,5,5,1,5,5,5,1,1,1,1,5,5,1,1,1,5,1,5
1,1,5,1,5,5,5,5,1,5,5,3,1,5,5,1,5,5,1,1,1,1,5,1,5,5,1,5,1,5,5,5,1,5,1,1,1,1,1,5,1,5,5,5,5,1,1,1,1,1,1,1,1,1,5,1,5
1,5,5,1,5,5,5,1,5,5,5,2,1,5,5,5,5,4,5,5,4,5,5,1,5,5,1,5,1,0,1,1,2,1,1,1,1,1,1,5,5,1,5,5,5,1,5,1,1,1,1,1,1,5,5,1,5
1,5,1,5,1,5,5,5,1,1,5,1,5,5,5,5,5,5,5,5,1,5,5,1,5,5,1,5,1,1,1,1,5,1,1,1,1,1,5,1,5,1,5,5,5,1,5,5,1,1,5,5,1,1,5,1,5
1,5,1,1,1,5,5,5,1,1,5,1,5,5,5,5,5,5,1,1,1,4,1,5,1,5,1,1,1,5,1,1,1,4,1,1,5,1,1,5,1,4,4,1,4,2,1,1,1,1,1,1,1,1,5,5,1
1,5,1,5,1,5,5,5,1,1,5,5,1,5,5,5,5,5,5,5,1,5,5,1,5,5,3,5,1,1,1,1,1,1,1,1,1,1,1,5,5,1,5,5,5,1,1,1,1,1,5,5,1,1,5,1,5
1,4,1,5,1,5,5,5,1,4,3,1,5,5,5,5,5,5,1,1,1,1,1,5,1,5,1,1,1,5,1,1,1,1,5,1,5,1,5,1,5,1,5,5,5,1,2,1,1,1,4,4,5,5,5,1,5
5,5,5,1,5,5,5,5,1,5,5,2,1,5,5,5,5,1,0,1,5,1,1,5,5,5,1,1,5,5,1,1,5,5,1,1,1,1,1,5,5,1,5,5,5,1,1,1,5,1,5,5,5,5,5,1,5
1,1,5,1,5,5,5,5,1,5,5,5,1,5,5,5,5,1,1,1,1,1,1,5,4,4,1,1,1,5,1,1,1,0,5,1,5,1,5,5,5,1,5,5,5,1,1,1,1,1,1,1,1,1,5,1,5
1,1,1,1,1,0,0,0,0,0,0,0,1,5,4,4,1,1,1,1,1,1,1,5,1,5,1,1,1,1,1,1,1,5,4,1,5,1,1,5,5,1,5,5,1,5,1,1,1,1,1,1,1,1,1,1,1
1,5,1,1,5,5,5,5,1,5,5,2,1,5,5,5,5,1,1,1,5,5,5,1,5,1,5,5,1,5,1,1,5,1,5,1,1,1,1,5,1,5,1,1,5,1,1,1,1,1,1,1,1,1,5,1,5
1,5,5,1,5,1,1,5,1,5,5,5,5,5,5,5,5,1,1,5,1,1,1,5,1,5,1,1,1,5,5,5,5,1,4,1,5,1,1,5,5,1,5,5,5,1,5,5,1,5,5,5,1,1,5,1,5
1,1,1,1,5,1,1,1,5,5,5,5,1,5,1,1,1,1,1,1,1,5,1,5,1,5,1,1,1,5,1,1,5,1,1,1,1,1,5,1,5,1,5,5,5,1,1,1,5,1,5,5,1,1,5,1,5
1,1,1,1,5,5,5,1,5,1,1,4,1,5,5,1,5,3,1,1,1,1,5,1,1,5,3,5,1,1,1,1,1,1,5,1,1,1,1,5,5,1,1,1,5,1,1,1,1,1,1,1,1,1,5,5,1
1,1,1,1,4,4,4,3,3,5,1,5,1,5,2,5,4,1,5,4,5,1,1,5,1,5,1,1,1,5,1,1,1,4,5,1,5,1,1,5,5,1,5,5,5,1,1,1,5,5,1,1,1,1,2,1,4
1,5,1,1,5,1,5,1,5,5,5,4,1,5,5,5,5,5,5,5,1,5,5,1,5,5,5,5,1,5,1,1,5,1,1,1,1,1,5,1,5,1,5,5,5,1,5,5,1,1,5,5,1,1,5,1,5
1,5,5,5,1,5,5,5,1,1,5,1,5,5,5,5,5,1,0,1,1,1,1,5,1,5,1,1,5,5,1,1,1,1,1,1,1,1,1,5,5,1,5,5,5,1,1,1,1,1,5,5,1,1,5,1,5
1,1,5,1,5,5,5,5,1,1,5,1,5,5,5,5,5,1,1,1,1,1,1,5,1,1,1,1,1,5,1,1,4,1,5,1,5,1,1,1,5,1,5,5,5,1,1,1,5,1,5,1,1,1,5,1,5
1,5,5,5,1,1,5,5,1,5,5,5,1,5,1,5,5,1,0,5,5,5,1,5,1,5,5,1,5,5,1,1,5,5,5,5,5,1,1,1,1,5,5,5,5,1,5,1,1,5,1,1,1,1,5,1,5
1,5,5,5,1,5,5,5,1,1,5,1,5,5,5,5,5,1,1,1,1,1,1,5,1,5,1,1,1,5,1,1,1,1,5,1,5,1,1,1,5,1,5,5,5,1,1,1,1,1,1,5,1,1,5,5,1
1,5,5,5,1,5,5,5,1,1,5,3,1,5,5,5,5,4,5,5,1,1,5,1,1,5,1,1,1,5,1,1,5,1,5,5,5,1,5,1,1,5,5,5,5,1,1,1,1,1,5,5,5,5,5,5,1
5,5,5,1,5,5,5,5,1,1,5,3,1,5,5,5,5,5,5,5,5,1,1,5,1,1,1,1,5,5,1,5,5,5,1,1,1,1,1,5,1,5,5,5,5,1,5,1,1,1,1,1,5,1,5,1,5
5,5,5,5,1,5,5,5,1,5,1,5,5,5,5,5,5,1,1,1,1,1,1,5,5,5,1,1,5,5,0,1,1,1,5,5,1,1,1,5,5,1,1,5,5,1,1,1,1,5,1,4,1,4,5,1,5
5,5,5,1,5,5,5,5,1,5,5,5,1,5,5,5,5,1,1,1,5,5,5,1,5,5,5,1,5,5,1,1,5,5,5,5,5,1,5,5,1,5,1,5,5,1,1,1,1,1,1,1,5,1,5,1,5
1,5,5,1,5,5,5,5,1,5,5,5,2,5,5,5,5,1,1,1,5,1,1,5,1,5,1,1,1,5,1,1,1,5,5,1,5,1,1,5,5,1,5,5,5,1,1,1,1,1,1,4,1,1,1,1,1
1,5,5,1,5,5,5,5,1,5,1,2,1,5,5,5,5,1,5,5,1,1,1,5,1,2,1,1,5,5,1,1,5,1,5,1,5,1,1,5,5,1,5,5,5,1,1,1,5,1,5,1,5,1,5,5,1
1,5,5,1,5,5,5,5,1,1,5,1,5,5,5,5,5,1,1,1,1,1,1,5,1,1,1,1,1,5,1,1,1,1,5,1,5,1,1,1,5,1,5,5,5,1,1,1,5,1,5,1,1,1,5,5,1
1,1,5,1,5,5,5,1,5,5,4,5,1,5,5,5,5,3,1,1,5,3,5,1,5,5,4,4,1,1,1,1,1,1,5,1,1,1,5,5,1,4,3,3,5,1,5,1,1,1,1,1,1,1,5,5,1
1,1,1,1,1,5,5,5,1,5,5,5,1,5,1,1,1,5,1,1,5,5,1,5,5,5,5,1,5,5,1,1,1,5,1,1,4,1,5,5,1,5,5,5,5,1,1,1,1,1,1,4,1,1,5,1,5
5,1,1,5,1,5,5,1,1,5,5,2,1,5,5,5,5,5,5,5,5,5,1,5,5,5,1,5,1,5,1,1,5,5,1,1,1,1,1,5,5,1,5,5,5,1,5,1,1,1,5,5,1,1,5,1,5
1,1,1,1,5,5,5,5,1,5,5,2,1,5,1,1,1,1,5,1,1,0,1,5,1,5,0,5,5,5,1,1,1,5,1,1,1,1,5,5,1,1,1,1,5,1,1,1,1,1,1,1,1,1,5,1,5
1,5,5,1,5,5,5,5,1,5,5,5,1,1,5,5,1,1,5,5,5,5,1,5,1,5,1,1,1,5,1,1,5,1,5,1,5,1,1,5,5,5,5,5,5,1,1,1,1,1,4,4,1,1,5,1,5
1,5,5,1,5,5,5,5,1,1,5,1,5,5,5,5,1,4,0,1,1,1,1,5,1,1,1,1,1,5,1,1,3,1,5,1,5,1,1,1,5,1,5,5,5,1,1,1,1,1,4,1,1,1,5,1,4
1,5,5,5,1,5,5,5,1,1,5,1,5,5,5,5,5,1,1,4,1,1,1,5,1,1,1,1,1,5,1,1,1,1,5,1,5,1,1,1,5,1,5,5,5,1,1,1,5,1,1,4,5,1,5,1,5
1,5,5,5,1,5,5,5,1,1,5,1,5,5,5,5,5,1,1,0,1,1,5,1,5,5,1,1,1,5,1,1,5,5,1,1,1,1,1,5,5,1,5,5,5,1,1,1,1,1,4,4,4,1,5,5,1
5,5,5,5,1,5,5,5,1,5,5,5,1,5,5,1,1,5,5,1,5,5,1,5,1,5,1,1,5,5,5,5,5,5,5,1,5,1,1,5,5,1,5,5,1,1,1,1,1,5,5,5,5,1,5,1,5
1,5,5,5,1,5,5,5,1,5,5,5,1,5,5,5,5,5,1,1,4,1,1,5,1,4,5,1,1,5,1,1,1,5,5,1,5,1,1,5,5,1,5,5,5,1,1,1,1,1,5,5,1,1,5,1,5
1,1,1,1,5,5,5,5,1,5,5,5,1,5,5,5,5,5,5,5,1,5,1,5,1,5,5,5,1,1,1,1,5,1,1,1,1,1,1,5,5,1,5,5,5,1,5,5,1,1,5,5,5,1,5,1,5
1,1,5,1,5,5,5,1,4,5,5,3,1,5,5,5,5,1,5,5,5,1,5,4,5,5,4,2,1,5,1,1,5,1,1,1,1,1,1,5,5,5,1,5,4,1,1,1,1,1,1,1,1,1,5,1,5
3,5,4,1,5,1,4,1,5,5,1,5,1,5,1,1,1,4,5,5,5,5,1,5,1,2,1,3,1,5,2,1,5,3,3,1,1,1,1,5,5,1,5,5,5,1,5,1,1,1,5,5,1,1,5,2,4
1,5,1,1,5,5,5,5,1,5,5,5,1,5,1,1,1,5,5,5,1,5,5,1,5,5,1,5,1,1,2,2,5,1,1,1,1,1,5,1,5,1,5,5,5,1,5,5,1,1,5,5,1,1,5,1,5
1,5,1,5,1,5,5,5,1,1,5,1,5,5,5,5,5,5,5,1,1,5,5,1,5,5,5,5,1,5,1,1,5,1,1,1,1,1,1,5,1,5,1,1,5,1,5,1,1,1,1,1,1,1,5,1,5
1,4,5,1,5,4,5,5,1,5,5,5,1,5,1,1,1,5,5,5,1,5,5,1,5,5,1,1,1,5,5,5,5,5,1,1,1,1,4,5,5,1,5,5,5,1,1,1,1,4,4,1,1,1,5,1,5
5,5,4,1,5,1,5,5,1,5,5,5,1,5,5,5,5,5,5,5,1,5,1,5,1,5,1,4,5,5,1,1,5,1,4,1,1,1,5,5,5,1,5,5,5,1,5,5,1,1,5,5,5,5,5,1,5
5,1,1,1,5,5,5,5,1,5,2,1,5,5,5,1,5,1,0,1,5,1,1,5,1,5,1,1,1,1,5,1,5,5,1,1,1,1,1,5,5,1,5,5,5,1,1,1,5,5,1,1,1,1,1,1,1
1,1,5,1,5,5,5,5,1,5,5,5,1,5,5,5,5,1,5,5,1,5,1,5,2,5,1,1,1,5,1,1,5,1,4,1,5,1,1,5,5,1,5,5,1,1,1,1,1,5,1,4,1,1,4,1,4
5,5,5,5,0,5,5,5,1,1,5,5,5,1,5,5,5,1,1,1,1,0,1,5,5,5,1,1,5,5,1,1,1,5,1,1,1,1,1,5,5,5,1,1,5,1,1,1,1,5,1,1,5,1,5,1,5
4,1,1,1,5,5,5,5,1,5,5,5,1,5,5,5,5,1,1,1,1,1,1,5,4,5,4,1,1,5,1,1,5,5,1,1,1,1,1,5,1,5,1,5,5,1,1,1,1,1,4,5,5,4,5,1,5
1,1,5,5,5,5,5,5,1,1,5,1,5,5,5,5,5,5,5,1,1,3,1,5,1,1,1,1,1,5,1,1,5,5,5,5,5,1,1,5,5,1,5,5,5,1,1,1,1,1,1,5,1,1,5,1,5
5,5,5,1,5,5,5,5,1,1,5,1,5,5,5,5,5,1,1,5,1,1,1,5,1,5,1,1,1,5,1,1,5,1,5,1,1,5,1,5,5,1,5,5,5,1,1,1,1,5,5,5,1,1,5,5,1
1,5,5,5,1,5,5,5,1,1,5,1,5,5,5,5,5,1,1,1,1,1,1,5,1,3,1,1,1,5,1,1,1,1,1,1,5,1,1,1,5,1,5,5,5,1,1,1,5,1,1,1,1,1,5,5,1
1,5,5,5,1,5,5,5,1,1,3,5,5,2,5,5,1,2,1,1,1,5,1,5,4,5,1,1,1,5,1,1,1,5,1,1,1,1,1,5,5,5,1,1,5,1,1,1,1,1,1,1,1,1,1,1,1
1,5,5,5,1,5,5,5,1,1,5,1,5,5,5,5,5,4,1,1,1,1,1,5,1,5,1,5,1,5,4,1,5,5,1,1,5,1,1,5,5,1,5,5,5,1,1,1,1,1,5,1,1,1,5,5,1
1,5,5,1,5,5,5,5,1,5,5,4,1,1,5,5,5,3,1,1,1,1,1,5,1,5,1,1,1,5,1,1,4,2,5,1,5,1,5,1,3,3,5,5,5,1,1,1,1,1,2,1,1,1,5,5,1
1,5,5,5,1,5,5,5,1,5,5,1,5,5,5,5,5,2,1,1,1,1,1,5,1,5,1,1,1,5,1,1,1,1,4,5,5,1,5,5,5,1,5,5,5,1,1,1,1,1,5,4,1,1,5,5,1
1,1,5,1,5,5,5,5,1,5,5,1,5,1,5,5,5,1,1,1,5,1,1,5,1,5,1,1,1,5,1,1,1,1,1,1,1,1,1,5,5,1,1,1,5,1,1,1,5,1,1,1,1,1,1,1,1
5,5,5,1,5,5,5,5,1,5,5,3,1,5,5,5,5,5,0,5,5,5,1,5,5,5,1,1,5,5,5,1,5,5,1,1,1,1,1,5,5,1,5,5,5,1,5,1,1,1,1,1,5,5,5,1,5
1,5,5,1,5,5,1,5,1,5,5,1,5,5,5,5,5,1,5,1,5,5,5,5,5,5,1,1,1,5,5,1,1,5,5,1,5,1,1,5,5,1,5,5,5,1,1,1,1,5,5,5,5,1,5,1,5
1,5,5,1,1,5,5,5,1,5,5,5,1,5,5,4,4,5,4,5,5,5,1,5,1,5,4,2,1,5,1,1,1,5,1,1,1,1,1,5,5,1,5,5,5,1,5,1,1,1,5,4,2,1,5,1,5
1,5,1,5,1,5,5,5,1,1,3,5,5,5,5,5,0,1,1,1,1,1,5,1,5,5,5,1,1,5,1,1,1,5,1,1,1,1,5,1,5,5,5,5,5,1,1,1,1,1,1,1,1,1,4,1,4
5,1,5,1,5,5,5,1,5,5,5,3,1,5,5,1,1,5,5,5,5,5,1,5,5,5,1,1,1,5,5,5,5,5,5,1,5,1,1,5,5,1,5,5,5,1,5,1,5,1,5,5,5,1,5,1,5
1,5,5,1,5,5,5,5,1,5,5,5,1,5,5,5,5,2,5,5,5,1,1,5,4,5,1,1,5,5,5,5,5,1,5,1,1,1,5,1,5,1,2,2,4,1,1,1,1,1,1,1,1,1,1,1,1
5,5,5,5,1,5,5,5,1,1,5,1,5,5,5,5,5,1,1,1,1,1,1,1,1,1,1,1,1,5,1,1,1,1,5,1,5,1,1,4,5,1,5,5,5,1,1,1,4,1,1,1,1,1,5,5,1
1,5,5,1,5,5,5,5,1,5,5,5,1,5,5,5,5,5,5,5,5,5,1,5,1,5,1,1,5,5,1,1,5,1,1,1,4,1,5,1,5,1,5,5,5,1,1,1,1,1,4,5,1,1,5,1,5
1,5,5,1,1,5,5,5,1,1,5,1,5,5,5,5,5,1,5,1,1,1,1,5,4,5,1,1,1,5,1,1,5,5,5,5,5,1,1,5,5,1,5,5,5,1,1,1,1,5,5,5,1,1,5,1,5
1,1,5,1,5,5,5,5,5,5,5,5,1,5,1,1,1,5,5,5,1,5,1,5,5,5,1,1,1,1,1,1,5,5,1,1,5,1,1,5,5,1,5,5,5,1,5,4,5,1,5,5,1,1,1,1,1
1,5,5,1,5,5,5,5,1,5,5,5,1,5,5,5,5,1,5,4,5,1,1,5,1,5,1,1,1,5,1,1,5,5,5,1,5,1,1,5,5,1,5,5,5,1,1,1,1,1,5,4,5,1,5,1,5
1,5,5,1,5,5,5,5,1,5,5,5,1,5,4,4,5,5,5,5,4,5,5,1,5,5,2,1,5,5,5,5,5,5,1,1,1,1,5,5,5,1,1,1,5,1,1,1,1,1,1,1,1,1,5,1,5
1,5,5,1,5,5,5,5,1,5,5,5,1,5,5,5,5,1,1,1,1,1,5,1,1,1,1,1,1,5,1,1,1,1,1,1,5,5,1,5,5,1,5,5,5,1,1,1,1,1,1,1,1,1,5,1,5
1,5,5,1,5,5,5,5,1,5,5,4,1,5,5,5,5,1,1,1,1,1,1,5,1,5,1,1,1,5,1,1,1,1,5,1,5,1,1,1,5,1,5,5,5,1,1,1,1,1,4,1,1,1,5,5,1
1,5,5,1,5,5,5,4,2,5,5,3,1,5,5,5,5,1,1,1,4,1,1,5,2,4,1,1,1,5,1,1,3,5,5,3,5,1,2,4,4,4,4,1,5,1,1,1,1,1,2,2,4,2,5,1,5
1,5,5,5,1,5,5,5,1,1,5,1,5,1,5,5,5,1,5,5,1,5,1,5,1,5,1,1,5,5,1,1,5,5,1,1,1,1,1,5,1,5,5,5,5,1,5,1,1,1,4,1,5,1,5,1,5
1,5,5,1,5,4,4,5,1,5,4,3,1,5,5,5,5,5,5,5,5,5,1,5,5,5,1,2,5,5,1,1,5,5,5,1,5,1,5,1,5,1,5,5,5,1,5,1,1,1,5,5,1,1,5,1,5
1,5,5,1,5,1,1,1,5,5,5,2,1,5,1,1,1,5,5,1,1,5,1,5,4,5,5,5,1,5,1,1,5,1,1,1,1,1,1,5,5,1,5,5,5,1,5,1,1,1,5,5,1,1,5,1,5
1,1,1,5,1,5,5,5,1,5,4,6,1,5,1,1,1,1,1,1,1,0,5,1,5,0,1,5,1,1,1,5,1,1,5,2,2,2,1,5,5,1,1,1,5,1,1,5,1,1,1,1,1,1,5,1,5
1,5,5,5,1,5,5,5,1,1,5,1,5,5,5,5,5,1,1,1,1,1,1,5,1,1,1,1,1,5,5,1,5,1,5,1,5,1,1,1,5,1,5,5,5,1,1,1,5,5,1,1,1,1,5,1,5
1,5,1,1,5,5,5,5,1,5,5,2,1,5,5,5,5,5,5,5,1,5,5,1,5,5,3,5,1,5,1,1,5,1,1,5,1,1,5,1,5,1,5,5,5,1,5,5,1,1,5,5,1,1,5,1,5
1,4,1,1,5,5,4,5,1,5,5,2,1,5,3,3,3,5,0,1,5,5,5,1,5,5,3,5,5,1,1,1,1,1,5,1,1,1,1,5,1,5,1,1,5,1,1,1,1,1,1,1,1,1,5,1,5
1,5,5,5,1,5,5,5,1,5,1,5,1,5,5,5,5,1,0,5,5,5,5,1,5,5,1,1,5,5,1,1,5,5,1,1,1,1,1,5,1,5,0,0,1,1,1,1,1,1,1,1,1,1,5,5,1
5,1,5,5,1,5,5,5,1,1,5,1,5,5,5,5,5,1,1,1,1,1,1,5,1,5,1,1,5,5,1,1,5,2,5,1,5,1,1,1,5,1,5,5,5,1,1,1,5,5,5,5,1,1,5,5,1
1,1,5,1,5,5,5,5,1,5,5,5,1,5,5,5,5,1,1,1,1,1,1,5,1,5,5,1,1,5,5,1,5,5,1,1,4,1,1,5,5,1,5,5,5,1,1,1,5,1,5,1,1,1,5,1,5
1,4,1,5,1,5,5,5,1,2,4,2,1,3,5,5,5,4,1,4,1,1,1,5,1,3,1,1,1,5,1,1,4,1,5,1,5,1,1,1,5,1,5,5,5,1,5,1,1,1,4,2,1,1,5,1,5
5,0,5,3,3,5,5,5,1,3,4,6,3,5,5,5,1,1,1,1,5,1,1,5,1,2,1,1,1,5,5,1,1,5,5,1,5,1,1,5,5,1,5,5,5,1,1,1,5,1,4,1,1,1,5,5,1
5,5,5,5,1,5,5,5,1,5,1,5,1,5,1,5,5,1,1,1,5,1,1,5,1,5,1,1,1,5,5,1,1,5,1,1,5,1,5,5,5,1,5,5,5,1,1,1,5,1,1,1,1,1,5,5,1
5,1,1,1,5,5,5,5,1,5,1,5,1,5,5,5,5,1,1,1,5,1,1,5,1,5,1,1,1,5,1,1,1,5,5,1,5,1,1,5,5,1,5,5,5,1,1,1,5,5,1,1,1,1,1,1,5
1,1,5,1,5,1,5,1,5,5,1,5,1,5,1,1,1,1,5,5,1,1,1,5,1,4,1,1,1,5,1,1,5,1,5,1,5,1,1,1,5,1,5,5,5,1,1,1,1,5,5,5,1,1,5,1,5
